1111111111111111
10P1C10001000001
11E1000001000001
1010000000000001
1111111000000011
1000000000000001
1111111111111111